res/tileset.png
10
10
32
32
2.0
28 26 27 27 27 27 27 27 30 28 
8 491 433 493 494 495 496 58 508 8 
38 511 512 58 514 515 516 517 518 38 
38 521 1 1 1 58 1 527 528 38 
38 531 532 533 534 535 536 537 58 38 
38 510 491 492 493 494 495 58 497 38 
38 520 511 512 58 514 515 516 517 38 
38 58 521 1 1 1 1 1 527 38 
48 540 531 532 533 534 58 536 537 48 
28 26 27 27 27 27 27 27 30 28 
0 0 0 0 0 0 0 0 0 0 
0 0 0 0 0 0 0 1 0 0 
0 0 0 1 0 0 0 0 0 0 
0 0 0 0 0 1 0 0 0 0 
0 0 0 0 0 0 0 0 1 0 
0 0 0 0 0 0 0 1 0 0 
0 0 0 0 1 0 0 0 0 0 
0 1 0 0 0 0 0 0 0 0 
0 0 0 0 0 0 1 0 0 0 
0 0 0 0 0 0 0 0 0 0 
